111111111111111111111111111111333333
000000000000000000000000000001333333
122222222222222222222222222201333333
100000000000000000000000000201333333
102333333333333333333333330201333333
102000000000000000000000030201333333
102034444444444444444444030201333333
102030000000000000000004030201333333
102030455555555555555504030201333333
102030400000000000000504030201333333
10203040566666666666050403020133333
10203040500000000006050403020133333
1020304050677777770605040302013333333
102030405060000007060504030201333333
102030405060788807060504030201333333
10203040506070880706050403020133333
102030405060700007060504030201333333
1020304050607777770605040302013333333
102030405060000000060504030201333333
102030405066666666660504030201333333


